########################
#......................#
#.....##.......##.....#
#.....#............#..#
#......##..........#..#
#.......#.............#
#.......#.............#
#.......#.............#
#.......##............#
#.........##..........#
#.....................#
#.....................#
#.........#...........#
#.........#...........#
#.........#...........#
#.........#...........#
#..........##.........#
#.....................#
#.....................#
########################
